++++++++++++
+       0+ +
+ ++++++++ +
+          +
+ ++++     +
+ +       A+
++++++++++++
