++++++++++++
+       0+ +
+ ++++++++A+
+          +
+ ++++     +
+ +        +
++++++++++++
