#domain
hospital
#levelname
MA_example
#colors
red: 0, A
green: 1, B
blue: 2, C
#initial
++++++++++++
+ 2        +
+1 B       +
+0A        +
+          +
+     C    +
+          +
++++++++++++
#goal
++++++++++++
+         A+
+          +
+         B+
+          +
+          +
+         C+
++++++++++++
#end
