#domain
hospital
#levelname
MA_agent_hard
#colors
red: 0, A
green: 1, B, C
#initial
++++++++++++
+  A       +
+  B     0 +
+  C++++   +
+      +   +
++++++ +   +
+1     + +++
++++++++++++
#goal
++++++++++++
+         B+
+          +
+   ++++   +
+      +   +
++++++ +C  +
+      +A+++
++++++++++++
#end
