#domain
hospital
#levelname
MA_example
#colors
red: 0, A
green: 1, B
#initial
++++++++++++
+       1+ +
+ ++++++++A+
+          +
+B++++++++ +
+ +   0    +
++++++++++++
#goal
++++++++++++
+        +A+
+ ++++++++ +
+          +
+ ++++++++ +
+B+        +
++++++++++++
#end
