#domain
hospital
#levelname
MA_priority
#colors
red: 0, A
blue: 1, B
#initial
++++++++++++++
+0  B+++++++++
+            +
+1  A+++++++++
++++++++++++++
#goal
++++++++++++++
+    +++++++++
+       A   B+
+    +++++++++
++++++++++++++
#end