#domain
hospital
#levelname
MA_priority
#colors
red: 0, A
green: 1, B
#initial
+++++++++++++
+           +
+     A     +
++++++ ++++++
+0         1+
++++++ ++++++
+     B     +
+           +
+++++++++++++
#goal
+++++++++++++
+     A     +
+           +
++++++ ++++++
+           +
++++++ ++++++
+           +
+     B     +
+++++++++++++
#end
