#domain
hospital
#levelname
SA_grid64x64
#colors
red: 0, A
#initial
++++++++++++++++++++++++++++++++++++++++++++++++++++++++++++++++++
+                                                                +
+                                                                +
+                                 A                              +
+0                                                               +
+                                                                +
+                                                                +
+                                                                +
+                                                                +
+                                                                +
+                                                                +
+                                                                +
+                                                                +
+                                                                +
+                                                                +
+                                                                +
+                                                                +
+                                                                +
+                                                                +
+                                                                +
+                                                                +
+                                                                +
+                                                                +
+                                                                +
+                                                                +
+                                                                +
+                                                                +
+                                                                +
+                                                                +
+                                                                +
+                                                                +
+                                                                +
+                                                                +
+                                                                +
+                                                                +
+                                                                +
+                                                                +
+                                                                +
+                                                                +
+                                                                +
+                                                                +
+                                                                +
+                                                                +
+                                                                +
+                                                                +
+                                                                +
+                                                                +
+                                                                +
+                                                                +
+                                                                +
+                                                                +
+                                                                +
+                                                                +
+                                                                +
+                                                                +
+                                                                +
+                                                                +
+                                                                +
+                                                                +
+                                                                +
+                                                                +
+                                                                +
+                                                                +
+                                                                +
+                                                                +
++++++++++++++++++++++++++++++++++++++++++++++++++++++++++++++++++
#goal
++++++++++++++++++++++++++++++++++++++++++++++++++++++++++++++++++
+                                                                +
+                                                                +
+                                                                +
+                                                                +
+                                                                +
+                                                                +
+                                                                +
+                                                                +
+                                                                +
+                                                                +
+                                                                +
+                                                                +
+                                                                +
+                                                                +
+                                                                +
+                                                                +
+                                                                +
+                                                                +
+                                                                +
+                                                                +
+                                                                +
+                                                                +
+                                                                +
+                                                                +
+                                                                +
+                                                                +
+                                                                +
+                                                                +
+                                                                +
+                                                                +
+                                                                +
+                                                                +
+                                                                +
+                                                                +
+                                                                +
+                                                                +
+                                                                +
+                                                                +
+                                                                +
+                                                                +
+                                                                +
+                                                                +
+                                                                +
+                                                                +
+                                                                +
+                                                                +
+                                                                +
+                                                                +
+                                                                +
+                                                                +
+                                                                +
+                                                                +
+                                                                +
+                                                                +
+                                                                +
+                                                                +
+                                                                +
+                                                                +
+                                                                +
+                                                                +
+                                                                +
+                                                                +
+                                                                +
+                                                           A    +
++++++++++++++++++++++++++++++++++++++++++++++++++++++++++++++++++
#end
