#domain
hospital
#levelname
SA_galaxy
#colors
red: 0, A
#initial
+++++++++++++++++
+A              +
+++++++++++++++ +
+ +             +
+ +     +++++++++
+ +             +
+ +++++++++++++ +
+               +
+  +++          +
+  A +          +
++++ ++++++++ + +
+             + +
+ +++++++++++++++
+              0+
+++++++++++++++++
#goal
+++++++++++++++++
+               +
+++++++++++++++ +
+ +             +
+ +     +++++++++
+ +             +
+ +++++++++++++ +
+               +
+  +++          +
+    +A         +
++++ ++++++++ + +
+             + +
+ +++++++++++++++
+              A+
+++++++++++++++++
#end
