+++++++++
+   +A+ +
+   +   +
+ + + + +
+ + + + +
+     + +
+++++++++
